aaax	x
aab	aab-
aax	x
ad	a/d
a.d.	ada
anb.	anba
aud	auda
axba	az
bajn	bak
bang	banh
bank	bann
bgb	b-h
bhaa	bhab
bhal	b.j.
b/h	bh.
bmhc	bml
caan	cab
cbnb	cdb
chb.	chu
daad	daaf
daba	dabb
dada	daf
dag	dag-
duba	dubf
fady	fahn
fc	fhb
gaab	gaad
gala	gald
gb	g.b.
gg	ghaa
haad	haaf
haax	hab
halm	haly
hfc	h.m.
jaa	jaab
kau	kaub
laan	lab
lay	layd
laza	l.b.
maj.	maja
man.	mana
najb	najk
n.b.	nb.
nub	nul
unaa	unab
x	aaax
x	aax
zaal	zaam
zalf	zan
zana	zand
